20 20 20 20 20 20 20 20 20 20 20 20 20 20 20 20 20 20 20 20 20 20 20 20 20 20 20 20 20 20 20 20 20 20 20 20 20 20 20 20 20 20 20 20 20 20 20 20 20 20 20 20 20 20 20 20 20 20 20 20 20 20 20 20 20 20
20 20 20 20 20 20 20 20 20 20 20 20 20 20 20 20 20 20 20 20 20 20 20 20 20 20 20 20 20 20 20 20 20 20 20 20 20 20 20 20 20 20 20 20 20 20 20 20 20 20 20 20 20 20 20 20 20 20 20 20 20 20 20 20 20 20
20 20 20 20 20 20 20 20 20 20 20 20 20 20 20 20 20 20 20 20 20 20 20 20 20 20 20 20 20 20 20 20 20 20 20 20 20 20 20 20 20 20 20 20 20 20 20 20 20 20 20 20 20 20 20 20 20 20 20 20 20 20 20 20 20 20 
20 20 20 20 20 20 20 20 20 20 20 20 20 20 20 20 20 20 20 20 20 20 20 20 20 20 20 20 20 20 20 20 20 20 20 20 20 20 20 20 20 20 20 20 20 20 20 20 20 20 20 20 20 20 20 20 20 20 20 20 20 20 20 20 20 20 
20 20 20 20 20 20 20 20 20 20 20 20 20 20 20 20 20 20 20 20 20 20 20 20 20 20 20 20 20 20 20 20 20 20 20 20 20 20 20 20 20 20 20 20 20 20 20 20 20 20 20 20 20 20 20 20 20 20 20 20 20 20 20 20 20 20 
20 20 20 20 20 20 20 30 23 23 23 23 23 23 23 23 23 23 23 23 23 23 23 23 23 23 23 23 23 23 23 23 23 23 23 23 23 23 23 23 23 23 23 23 23 23 23 23 23 23 23 23 23 23 23 23 23 23 31 20 20 20 20 20 20 20 
20 20 20 20 20 20 20 24 10 10 10 10 10 10 10 10 10 10 10 10 10 10 10 10 10 10 10 10 10 10 10 10 10 10 10 10 10 10 10 10 10 10 10 10 10 10 10 10 10 10 10 10 10 10 10 10 10 10 22 20 20 20 20 20 20 20
20 20 20 20 20 20 20 24 10 10 10 10 10 10 10 10 10 10 10 10 10 10 10 10 10 10 10 10 10 10 10 10 10 10 10 10 10 10 10 10 10 10 10 10 10 10 10 10 10 10 10 10 10 10 10 10 10 10 22 20 20 20 20 20 20 20
20 20 20 20 20 20 20 24 10 10 10 10 10 10 10 10 10 10 10 10 10 10 10 10 10 10 10 10 10 10 10 10 10 10 10 10 10 10 10 10 10 10 10 10 10 10 10 10 10 10 10 10 10 10 10 10 10 10 22 20 20 20 20 20 20 20
20 20 20 20 20 20 20 24 10 10 10 10 10 10 10 10 10 10 10 10 10 10 10 10 10 10 10 10 10 10 10 10 10 10 10 10 10 10 10 10 10 10 10 10 10 10 10 10 10 10 10 10 10 10 10 10 10 10 22 20 20 20 20 20 20 20
20 20 20 20 20 20 20 24 10 10 10 10 10 10 10 10 10 10 10 10 10 10 10 10 10 10 10 10 10 10 10 10 10 10 10 10 10 10 10 10 10 10 10 10 10 10 10 10 10 10 10 10 10 10 10 10 10 10 22 20 20 20 20 20 20 20
20 20 20 20 20 20 20 24 10 10 10 10 10 10 10 10 10 10 10 10 10 10 10 10 10 10 10 10 10 10 10 10 10 10 10 10 10 10 10 10 10 10 10 10 10 10 10 10 10 10 10 10 10 10 10 10 10 10 22 20 20 20 20 20 20 20
20 20 20 20 20 20 20 24 10 10 10 10 10 10 10 10 10 10 10 10 10 10 10 10 10 10 10 10 10 10 10 10 10 10 10 10 10 10 10 10 10 10 10 10 10 10 10 10 10 10 10 10 10 10 10 10 10 10 22 20 20 20 20 20 20 20
20 20 20 20 20 20 20 24 10 10 10 10 10 10 10 10 10 10 10 10 10 10 10 10 10 10 10 10 10 10 10 10 10 10 10 10 10 10 10 10 10 10 10 10 10 10 10 10 10 10 10 10 10 10 10 10 10 10 22 20 20 20 20 20 20 20
20 20 20 20 20 20 20 24 10 10 10 10 10 10 10 10 10 10 10 10 10 10 10 10 10 10 10 10 10 10 10 10 10 10 10 10 10 10 10 10 10 10 10 10 10 10 10 10 10 10 10 10 10 10 10 10 10 10 22 20 20 20 20 20 20 20
20 20 20 20 20 20 20 24 10 10 10 10 10 10 10 10 10 10 10 10 10 10 10 10 10 10 10 10 10 10 10 10 10 10 10 10 10 10 10 10 10 10 10 10 10 10 10 10 10 10 10 10 10 10 10 10 10 10 22 20 20 20 20 20 20 20
20 20 20 20 20 20 20 24 10 10 10 10 10 10 10 10 10 10 10 10 10 10 10 10 10 10 10 10 10 10 10 10 10 10 10 10 10 10 10 10 10 10 10 10 10 10 10 10 10 10 10 10 10 10 10 10 10 10 22 20 20 20 20 20 20 20
20 20 20 20 20 20 20 24 10 10 10 10 10 10 10 10 10 10 10 10 10 10 10 10 10 10 10 10 10 10 10 10 10 10 10 10 10 10 10 10 10 10 10 10 10 10 10 10 10 10 10 10 10 10 10 10 10 10 22 20 20 20 20 20 20 20
20 20 20 20 20 20 20 24 10 10 10 10 10 10 10 10 10 10 10 10 10 10 10 10 10 10 10 10 10 10 50 41 51 10 10 10 10 10 10 10 10 10 10 10 10 10 10 10 10 10 10 10 10 10 10 10 10 10 22 20 20 20 20 20 20 20
20 20 20 20 20 20 20 24 10 10 10 10 10 10 10 10 10 10 10 10 10 10 10 10 10 10 10 10 10 10 42 40 44 10 10 10 10 10 10 10 10 10 10 10 10 10 10 10 10 10 10 10 10 10 10 10 10 10 22 20 20 20 20 20 20 20
20 20 20 20 20 20 20 24 10 10 10 10 10 10 10 10 10 10 10 10 10 10 11 11 11 11 11 11 11 11 42 40 44 11 11 11 11 11 11 11 10 10 10 10 10 10 10 10 10 10 10 10 10 10 10 10 10 10 22 20 20 20 20 20 20 20
20 20 20 20 20 20 20 24 10 10 10 10 10 10 10 10 10 10 10 10 10 10 11 11 11 11 11 11 11 11 42 40 44 11 11 11 11 11 11 11 10 10 10 10 10 10 10 10 10 10 10 10 10 10 10 10 10 10 22 20 20 20 20 20 20 20
20 20 20 20 20 20 20 24 10 10 10 10 10 10 10 10 10 10 10 10 10 10 11 11 11 11 11 11 11 11 42 40 44 11 11 11 11 11 11 11 10 10 10 10 10 10 10 10 10 10 10 10 10 10 10 10 10 10 22 20 20 20 20 20 20 20
20 20 20 20 20 20 20 24 10 10 10 10 10 10 10 10 10 10 10 10 10 10 11 11 11 11 11 11 11 11 42 40 44 11 11 11 11 11 11 11 10 10 10 10 10 10 10 10 10 10 10 10 10 10 10 10 10 10 22 20 20 20 20 20 20 20
20 20 20 20 20 20 20 24 10 10 10 10 10 10 10 10 10 10 10 10 10 10 11 11 11 11 11 10 10 10 42 40 44 11 11 11 11 11 11 11 10 10 10 10 10 10 10 10 10 10 10 10 10 10 10 10 10 10 22 20 20 20 20 20 20 20
20 20 20 20 20 20 20 24 10 10 10 10 10 10 10 10 10 10 10 10 10 10 11 11 11 11 11 11 11 11 42 40 44 11 11 11 11 11 11 11 10 10 10 10 10 10 10 10 10 10 10 10 10 10 10 10 10 10 22 20 20 20 20 20 20 20
20 20 20 20 20 20 20 24 10 10 10 10 10 10 10 10 10 10 10 10 10 10 11 11 11 11 11 11 11 11 42 40 44 11 11 11 11 11 11 11 10 10 10 10 10 10 10 10 10 10 10 10 10 10 10 10 10 10 22 20 20 20 20 20 20 20
20 20 20 20 20 20 20 24 10 10 10 10 10 10 10 10 10 10 10 10 10 10 11 11 11 11 11 11 11 10 47 40 46 10 11 11 11 11 10 10 10 10 10 10 10 10 10 10 10 10 10 10 10 10 10 10 10 10 22 20 20 20 20 20 20 20
20 20 20 20 20 20 20 24 10 10 10 10 10 10 10 10 10 10 10 41 41 41 41 41 41 41 41 41 41 47 40 40 40 46 41 41 41 41 41 41 41 41 41 41 41 41 51 10 10 10 10 10 10 10 10 10 10 10 22 20 20 20 20 20 20 20
20 20 20 20 20 20 20 24 10 10 10 10 10 10 10 10 10 10 42 40 40 40 40 40 40 40 40 40 40 40 40 40 40 40 40 40 40 40 40 40 40 40 40 40 40 40 44 10 10 10 10 10 10 10 10 10 10 10 22 20 20 20 20 20 20 20
20 20 20 20 20 20 20 24 10 10 10 10 10 10 10 10 10 10 42 40 45 43 43 43 43 43 43 43 43 48 40 40 40 45 43 43 43 43 43 43 43 43 43 43 43 43 52 10 10 10 10 10 10 10 10 10 10 10 22 20 20 20 20 20 20 20
20 20 20 20 20 20 20 24 10 10 10 10 10 10 10 10 10 10 42 40 44 10 11 11 11 11 11 11 11 10 48 40 45 10 11 11 11 11 11 11 11 11 11 11 11 11 11 10 10 10 10 10 10 10 10 10 10 10 22 20 20 20 20 20 20 20
20 20 20 20 20 20 20 24 10 10 10 10 10 10 10 10 10 10 42 40 44 10 11 11 11 11 11 11 11 11 42 40 44 11 11 11 11 11 11 11 11 11 11 11 11 11 11 10 10 10 10 10 10 10 10 10 10 10 22 20 20 20 20 20 20 20
20 20 20 20 20 20 20 24 10 10 10 10 10 10 10 10 10 10 42 40 44 10 11 11 11 11 11 11 11 11 42 40 44 11 11 11 11 11 11 11 11 11 11 11 11 11 11 10 10 10 10 10 10 10 10 10 10 10 22 20 20 20 20 20 20 20
20 20 20 20 20 20 20 24 10 10 10 10 10 10 10 10 10 10 42 40 44 10 11 11 11 11 11 11 11 11 42 40 44 11 11 11 11 11 11 11 11 11 11 11 11 11 11 10 10 10 10 10 10 10 10 10 10 10 22 20 20 20 20 20 20 20
20 20 20 20 20 20 20 24 10 10 10 10 10 10 10 10 10 10 42 40 44 10 11 11 11 11 11 11 11 11 42 40 44 11 11 11 11 11 11 11 11 11 11 11 11 11 11 10 10 10 10 10 10 10 10 10 10 10 22 20 20 20 20 20 20 20
20 20 20 20 20 20 20 24 10 10 10 10 10 10 10 10 10 10 42 40 44 10 11 11 11 11 11 11 11 11 42 40 44 11 11 11 11 11 11 11 11 11 11 11 11 11 11 10 10 10 10 10 10 10 10 10 10 10 22 20 20 20 20 20 20 20
20 20 14 20 20 20 20 24 10 10 10 10 10 10 10 10 10 10 42 40 44 10 11 11 11 11 11 11 11 11 42 40 44 11 11 11 11 11 11 11 11 11 11 11 11 11 11 10 10 10 10 10 10 10 10 10 10 10 22 20 20 20 20 20 20 20
20 20 20 20 20 20 20 24 10 10 10 10 10 10 10 10 10 10 42 40 44 10 10 10 10 10 10 11 10 10 42 40 44 11 11 11 11 10 10 10 10 10 10 10 10 11 11 10 10 10 10 10 10 10 10 10 10 10 22 20 20 20 20 20 20 20
20 20 20 20 20 20 20 24 10 10 10 10 10 10 10 10 10 10 42 40 44 10 10 10 10 10 10 10 10 10 42 40 44 11 11 11 11 10 10 10 11 10 10 11 10 11 11 10 10 10 10 10 10 10 10 10 10 10 22 20 20 20 20 20 20 20
20 20 20 20 20 20 20 24 10 10 10 10 10 10 10 10 10 10 49 43 52 10 10 10 10 10 10 10 10 10 42 40 44 11 11 11 11 10 10 11 10 10 11 10 10 11 11 10 10 10 10 10 10 10 10 10 10 10 22 20 20 20 20 20 20 20
20 20 20 20 20 20 20 24 10 10 10 10 10 10 10 10 25 21 21 21 21 21 28 10 10 10 10 10 10 10 42 40 44 11 11 11 11 10 10 10 10 10 10 10 10 11 11 10 10 10 10 10 10 10 10 10 10 10 22 20 20 20 20 20 20 20
20 20 20 20 20 20 20 24 10 10 10 10 10 10 10 10 22 20 20 20 20 20 24 10 10 10 10 10 10 10 42 40 44 11 11 11 11 10 10 10 10 10 10 10 10 11 11 10 10 10 10 10 10 10 10 10 10 10 22 20 20 20 20 20 20 20
20 20 20 20 20 20 20 29 21 21 21 21 21 21 21 21 32 20 20 20 20 20 24 10 10 10 10 10 10 10 42 40 44 11 11 11 11 11 10 10 10 10 10 10 10 11 11 10 10 10 10 10 10 10 10 10 10 10 22 20 20 20 20 20 20 20
20 20 20 20 20 20 20 20 20 20 20 20 20 20 20 20 20 20 20 14 20 20 24 10 10 10 10 10 10 10 42 40 44 11 11 11 11 10 10 11 10 10 10 10 10 11 11 10 10 10 10 10 10 10 10 10 10 10 22 20 20 20 20 20 20 20
20 20 20 20 20 20 20 30 23 23 23 23 23 23 23 23 31 20 20 20 20 20 24 10 10 10 10 10 10 10 42 40 44 11 11 11 11 10 10 10 10 10 10 10 10 11 11 10 10 10 10 10 10 10 10 10 10 10 22 20 20 20 20 20 20 20
20 20 20 20 20 20 20 24 10 10 10 10 10 10 10 10 22 20 20 20 20 20 24 10 10 10 10 10 10 10 42 40 44 11 11 11 11 10 10 10 10 10 10 10 10 11 11 10 10 10 10 10 10 10 10 10 10 10 22 20 20 20 20 20 20 20
20 20 20 20 20 20 20 24 10 10 10 10 10 10 10 10 26 23 23 23 23 23 27 10 10 10 10 10 10 10 42 40 44 11 11 11 11 11 11 10 10 10 11 11 11 11 11 10 10 10 10 10 10 10 10 10 10 10 22 20 20 20 20 20 20 20
20 20 20 20 20 20 20 24 10 10 10 10 10 10 10 10 10 10 10 10 10 10 10 10 10 10 10 10 10 10 42 40 44 10 10 10 10 10 10 10 10 10 10 10 10 10 10 10 10 10 10 10 10 10 10 10 10 10 22 20 20 20 20 20 20 20
20 20 20 20 20 20 20 24 10 10 10 10 10 10 10 10 10 10 10 10 10 10 10 10 10 10 10 10 10 10 49 43 52 10 10 10 10 10 10 10 10 10 10 10 10 10 10 10 10 10 10 10 10 10 10 10 10 10 22 20 20 20 20 20 20 20
20 20 20 20 20 20 20 24 10 10 10 10 10 10 10 10 10 10 10 10 10 10 10 10 10 10 10 10 10 10 10 10 10 10 10 10 10 10 10 10 10 10 10 10 10 10 10 10 10 10 10 10 10 10 10 10 10 10 22 20 20 20 20 20 20 20
20 20 20 20 20 20 20 24 10 10 10 10 10 10 10 10 10 10 10 10 10 10 10 10 10 10 10 10 10 10 10 10 10 10 10 10 10 10 10 10 10 10 10 10 10 10 10 10 10 10 10 10 10 10 10 10 10 10 22 20 20 20 20 20 20 20
20 20 20 20 20 20 20 24 10 10 10 10 10 10 10 10 10 10 10 10 10 10 10 10 10 10 10 10 10 10 10 10 10 10 10 10 10 10 10 10 10 10 10 10 10 10 10 10 10 10 10 10 10 10 10 10 10 10 22 20 20 20 20 20 20 20
20 20 20 20 20 20 20 24 10 10 10 10 10 10 10 10 10 10 10 10 10 10 10 10 10 10 10 10 10 10 10 10 10 10 10 10 10 10 10 10 10 10 10 10 10 10 10 10 10 10 10 10 10 10 10 10 10 10 22 20 20 20 20 20 20 20
20 20 20 20 20 20 20 24 10 10 10 10 10 10 10 10 10 10 10 10 10 10 10 10 10 10 10 10 10 10 10 10 10 10 10 10 10 10 10 10 10 10 10 10 10 10 10 10 10 10 10 10 10 10 10 10 10 10 22 20 20 20 20 20 20 20
20 20 20 20 20 20 20 24 10 10 10 10 10 10 10 10 10 10 10 10 10 10 10 10 10 10 10 10 10 10 10 10 10 10 10 10 10 10 10 10 10 10 10 10 10 10 10 10 10 10 10 10 10 10 10 10 10 10 22 20 20 20 20 20 20 20
20 20 20 20 20 20 20 29 21 21 21 21 21 21 21 21 21 21 21 21 21 21 21 21 21 21 21 21 21 21 21 21 21 21 21 21 21 21 21 21 21 21 21 21 21 21 21 21 21 21 21 21 21 21 21 21 21 21 32 20 20 20 20 20 20 20
20 20 20 20 20 20 20 20 20 20 20 20 20 20 20 20 20 20 20 20 20 20 20 20 20 20 20 20 20 20 20 20 20 20 20 20 20 20 20 20 20 20 20 20 20 20 20 20 20 20 20 20 20 20 20 20 20 20 20 20 20 20 20 20 20 20
20 20 20 20 20 20 20 20 20 20 20 20 20 20 20 20 20 20 20 20 20 20 20 20 20 20 20 20 20 20 20 20 20 20 20 20 20 20 20 20 20 20 20 20 20 20 20 20 20 20 20 20 20 20 20 20 20 20 20 20 20 20 20 20 20 20
20 20 20 20 20 20 20 20 20 20 20 20 20 20 20 20 20 20 20 20 20 20 20 20 20 20 20 20 20 20 20 20 20 20 20 20 20 20 20 20 20 20 20 20 20 20 20 20 20 20 20 20 20 20 20 20 20 20 20 20 20 20 20 20 20 20
20 20 20 20 20 20 20 20 20 20 20 20 20 20 20 20 20 20 20 20 20 20 20 20 20 20 20 20 20 20 20 20 20 20 20 20 20 20 20 20 20 20 20 20 20 20 20 20 20 20 20 20 20 20 20 20 20 20 20 20 20 20 20 20 20 20
20 20 20 20 20 20 20 20 20 20 20 20 20 20 20 20 20 20 20 20 20 20 20 20 20 20 20 20 20 20 20 20 20 20 20 20 20 20 20 20 20 20 20 20 20 20 20 20 20 20 20 20 20 20 20 20 20 20 20 20 20 20 20 20 20 20